 # ##### ####### # ################# ###
# #     #       # #                 #   #
# # # ### ### # # # ##### ##### ##### # #
# # #       # #   # #   #   #   #     # #
# # ######### ##### # # ### ##### ##### #
#   #       # #   # # #   #   #   #   # #
# ### ##### # # # # # ### ### # ### # # #
# #   #   # #   #     #     #   #   # # #
# # ### # # #### ########## ##### ### # #
# #     # #     #       # #     #   # # #
 ######## ##### # ##### # ##### ### # # #
#         #   #   # #   #     #     # # #
# ######### # ##### # ##### # ####### # #
# #     #   #   #   # #   # #         # #
# # ### # ##### # ### # # ##### ####### #
# #   #   #   # #   #   # #   # #       #
# ### ##### ### ### ##### # # ### ##### #
#     #     #   #   #   #   #   #   #   #
 ###### ### # ### # # # ##### # ### ####
#     # #   #   # # #D#     # #   # #   #
# ### # # ##### # # ####### ##### # # # #
# #   # #     #   #       #       #   # #
# ### # ### # ########### ######### ### #
#   # # # # # #         # #       #   # #
# # ### # # ### ####### # # ### # ### # #
# #   # # #     #     #   # #   # #   # #
# ### # # ####### # ######### ### # ### #
# # #   #   #   # # #         # # #   # #
# # ##### # ### # # # # ####### # ### # #
# #       #   #   #   #     #   # #   # #
# ### #### ## ### ######### # # # # ### #
#   #     # #   # #       # # #   # #   #
 ## ### # # ### # # ##### # # ####### # #
#O#   # # #     # # #   # # #         # #
# ### # # # ####### ### # # ########### #
#     # # #   #   #   #   # #       #   #
# #### ## ### # # ### # ### # ##### # ##
# #   #   # #   # #   # #     #     #   #
# # # # ### ##### # ### ####### ####### #
#   #   #           #           #       #
 ### ### ########### ########### #######
